11111111
100000E1
11100C01
1P000100
11111111