111111111111
1P0000000001
111111111111
1E000000C011
111111111111